0 0 0 0 0 0 0 0 0 0 0 0 0 0 0 0 0 0 0 0 0
0 0 0 0 0 0 ! 0 0 0 0 0 0 0 * 0 0 0 0 0 0
0 0 1 1 1 1 1 1 1 1 1 1 1 1 1 1 1 1 1 0 0
0 1 2 3 6 5 4 3 4 4 1 4 4 3 4 5 6 3 2 1 0
0 1 2 2 3 3 4 4 5 6 7 6 5 4 4 3 3 2 2 1 0
1 1 1 1 2 2 4 4 2 2 * 2 2 4 4 2 2 1 1 1 1
0 1 1 1 1 1 1 3 3 5 5 5 3 3 f 1 1 1 1 1 0
0 0 g 0 1 1 1 1 3 3 4 3 3 1 1 1 0 0 @ 0 0
0 0 0 0 0 0 0 1 2 2 3 2 2 1 0 0 0 0 0 0 0
0 0 0 @ 0 0 0 0 1 2 2 2 1 0 0 0 0 0 0 0 0
1 1 1 1 1 1 1 1 1 1 2 1 1 1 1 1 1 1 1 1 1
0 0 0 1 1 1 1 1 1 1 1 1 1 1 1 1 1 1 0 0 0
1 1 1 3 0 0 0 0 0 @ @ * 0 0 0 0 0 3 1 1 1
0 0 0 0 0 0 0 0 0 0 0 0 0 0 0 0 0 0 0 0 0
0 0 0 0 0 0 0 0 0 0 0 0 0 0 0 0 0 0 0 0 0
0 0 0 0 0 0 0 0 0 0 0 0 0 0 0 0 0 0 0 0 0
0 0 0 0 0 0 0 0 0 0 0 0 0 0 0 0 0 0 0 0 0
0 0 0 0 0 0 0 0 0 0 0 0 0 0 0 0 0 0 0 0 0
0 0 0 0 0 0 0 0 0 0 0 0 0 0 0 0 0 0 0 0 0
0 0 0 0 0 0 0 0 0 0 0 0 0 0 0 0 0 0 0 0 0

where b adds a bonus ball, and f speeds up the paddle (power up)